30
20
MRGGGGRRRMMMMMMMMRFFWWWRRRMMMM
W2WGGRGRRRMMMMMMRRFFRWWF4FFRMM
WWWGGRGGRRWMMMMMRFFFWWWFFFFRRM
WSWGGGGRRRWRRRRRRFFFFFGGFFFRRR
SSSSRGGGRRWRGGGGRRRWWWHHHHRHHR
RSSHHHHWWWWWGGGGRRRWWWHHHHHRRR
RRGGWFGGRRWWGGGGRRRRWWWGWSSSSR
RRGGHWGGMRWWWGGGRRRRRRWWWSSSRS
RRGGHWGGMRWWWWGGRRRRWWWWWGRRRR
RRRRRRRRRRWRGGGGRRRWRRWWWGRRRR
WRGGGGRRRRWRG3GGHHRRRRGGGGRRRR
WRWGGRGHHHRRGHHHRRRRWRGGGGRRRR
RWGGGRHHHRWRGHHHFFFWWRGGFFFFFF
RSGGFFFFFFWRGGGGFFFWWRHHFFFWWW
RRRRRFFFFFFFFFFFFFFWWRHHWWSSSS
RFFFFFFFFWWWFFFFRRRWWRGGGGWWWS
RFFFFFFFWWWFFFFFFRRWWRGGGGWWWW
RRGGHWGGMRWRGGGGRRRGWWGGGGRRRR
RRGGHWGGMRWRGGGGRRRRWWGGGGRR1R
RRRRRRRRRRWRGGGGRRRRWWGGGGRRRM
